1111111111111
10010000000C11
100001111100011
1P0011E00000001
111111111111111