111111111111100
10010000000C110
100001111100011
1P0011E00000001
111111111111111